{
  "level": [
    "      ###      ",
    "      #T#      ",
    "  #####T#####  ",
    " ##         ## ",
    "##  # # # #  ##",
    "#  ##     ##  #",
    "# ##  # #  ## #",
    "#     BPB     #",
    "####  ###  ####",
    "   #### ####   "
  ],
  "method": "a_star",
  "heuristic": "not_wall_stuck"
}