{
    "level": [
      "#############",
      "#   ###     #",
      "#  ## # #####",
      "# ##  ###  ##",
      "### B      ##",
      "##   PB #  ##",
      "#### B###  ##",
      "#  #  #TT  ##",
      "# ## ##T# ###",
      "# #      ## #",
      "# #     ##  #",
      "# #######   #",
      "#############"
    ]
}