{
  "level": [
    "     #####     ",
    "    ##   ##    ",
    "  ### B B ###  ",
    " ##   # #   ## ",
    "##           ##",
    "# B#  TTT #B  #",
    "#     TPT     #",
    "#  B# TTT  #B #",
    "##           ##",
    " ##   # #   ## ",
    "  ### B B ###  ",
    "    ##   ##    ",
    "     #####     "
  ]
}