{
    "level": [
      "#######",
      "###P T#",
      "# B #T#",
      "#  BB #",
      "#T  # #",
      "#   BT#",
      "#######"
    ]
}