{
  "level":[
            "#######",
            "#P    #",
            "# B T #",
            "#  B T#",
            "#######"
        ]
}