{
  "level":[
            "#######",
            "#P    #",
            "# B T #",
            "#  B T#",
            "#######"
        ],
  "method": "bfs"
}