{
    "level": [
    "########",
    "#  T   #",
    "#  B   #",
    "# ###  #",
    "#   #P #",
    "#  B T #",
    "########"
    ],
  "output": "results_3"
}